1111111111111111111111
1110000000000000000001
111P00CC00CC111CC001C1
11000CC1E00011100000P1
1111111111111111111111
