1111111111111111111111
11C000000P000000001111
111000CC00CC1101C11111
11000CC1E00P1110011111
1111111111111111111111






















