11111111111111
11CCC001000001
11CCC001000001
1PCC00000000E1
11111111111111
