11111111111111111111111111111111111111111111111111111111
10000000000000000000000000000000000000000000000000000001
10000000000000000000000000000000000000000000000000000001
100C0000000000000000000000000000111000000000000000000001
1000000000E000000000000011000011111100000000000000000001
1000P00000000000000P00011110001111110000P000000000000001
10000000000000000000000011000111111110000000000000000001
10000000000000000000000000000000000000000000000000000001
10000000000000000000000000000111111110000000000000000001
10000000000000000000000110010111111110000000000000000001
10000000000000000000000111100111111110000P00000000000001
10000000000000000000000111000000111100000000000000000001
11111111111111111111111111111111111111111111111111111111
