11111111111
1EEP0CEEE11
11111111111
