1111111111111111111111111111111111111111111
1ECEEEEEEEEEEEEEEEEEEEEEEEEEEEEEEEEEEEEEEE1
1EEEE1EEEEEEEEEEEEEEEEEEEEEEEEEEEEEEEEEEEE1
1EEE111EEEEEEE1111EEEEE11EEEEEEEEEEEEEEEEE1
1E11E1EEEEEEEE1111E11EEEEEEEEEEEEEEEEEEEEE1
1EEEEEEEEEEEEE1111EEEEEEEEEEEEEEEEEEEEEEEE1
1EEEEEEEEEEEEEEEEEEEEEEEEEEEEEEEEEEEEEEEEE1
1CEPEEEEEEEEEEEEEEEEEEEEEEEEEEEEEEEEEEEEEE1
1111111111111111111111111111111111111111111
