111111111111111111111111111111111111
11CCC0000000SPS0000000000000000P0001
11CC000P0000SSS0000000S0000000000001
1P0011111111111111111111111111111001
111111111111111111111111111111111001
111111111111111111111111111111111001
111111111110000000000000000000000001
11000000011000000000000111000S000001
1100S11001100SS0000000011100000C0001
110011100000000000000001110000000001
1000111000000C0000000001110000000001
1E0C1110000CCC0000000001110111110001
111111111111111111111111111111111111
